..####.#.##..####.##...####.##....##....##.#####..
##..####..##..##..#..#..##.#....###...#.##.#.#....
..##.###.#.##.#.###.####.####.###.##.#.###...##.##
..##.#...#########.#####.#..#..#..#.##.#..##.##..#
..###...#..###....#..##..###....#.....#.#..#.###..
..##..#.####.##.##..###.....####..####.#...###....
#...#.###.......#.###.#...##..##.###..###..##.##..
####.#.....##..#.#####..#..##...##.#..#.#.#.#.#.##
#...#.#..####.#..##.#..###..#..###.##.###.#..####.
##..###.####.###.###......#.####.#.#.##...##.#####
###..#.##.#...##...#...#.###.##.##...##.#.#.#...##
....#.##..#..#..##..........#..#..##....##...#...#
#...##.#.###.#.##.#.##.##.....##..####....##..#...
###......#...####.###.#.#.########..#####....#..#.
...#.##....#.#...#...##.##..#..#####..##...#..#.##
........#.####..###...##.#.#.....####.#.#.#...###.
....#.#.#..########...#.#..##....########.#...#.##
#..####..####.#..#..#.#.#.###.#..##.#.#...####.#..
##.##...###.###.####.##...###.##..###...#.####..#.
##...##.#####..#..#.....#.#..###.#..#.#....###...#
.#####..#######..##.#.#..#.#.###.#.#..#.#..##.....
#.#.####..##..###.###..#..####...#.#.###.###.##.##
.##..#..#.####.##.##.#.##..#..####..#....##.......
..#.#..#...##..#.#........###.##..##....#..#.....#
.......##..######.##..#......##.#.#.#...#.....#...
....#####....###..#..#...#.#...#...#.##.#.#.#..##.
####..####.##..##..#####..####..##..#.#...#.##..#.
...#.#...#.##.#####....##.#...##...###...###.#.#.#
..#...##.##.##.....#..#.##.##.#.#.......#.#.######
#.#.####.#.##.#.##.....#.#.#..##.#.#..#.###....#..
#..##.######..#.###..#.##.#####.###.#..#.#.#..#.#.
#..#....#.##.##..##.#....#..###...#.....#..#######
##.#..######..####.####..#.#....####...##.##.##.#.
.###..#..###.##..#..........#.##...##.#......##.##
...##.##..#.###.##..#..#..#.#.#..#.##..#.#.#.#####
##....#.##..#......###..######....###....##..#####
#.##.#..######..#.#.#.##.#..##.###.##...#.##.###..
..##....##...##.##.#.##..#.######....#.###.#.#..#.
#......####.#.##...####..#...##.#.###....##..####.
.###..###..#..#...#.##.###.##.#.####.##.###..#.##.
..#..#..###..#...#.#..#.#.#.##.##..#.#..####.....#
....####.#.#..##.###.#...#..##..####.#.####..##.#.
.#..######..#...##...#.##.####..#....#...#.####...
...###........##....#..##.#.....######.##..#######
...#.###.###..##..#####.##...##..#.#.#####..###.##
####..#....#..#.#.#...#######..##...##..#####....#
##..#..#.#..#.....######..#.##.##....#.##.#...#.#.
#####.#.##.#.##.#.#.#......#####.#.###..#.#.#.####
#.#.#.#..#..##.#..##.##..##.######...#....#.####..
###.###.#####.....##.##...###.....##.#.##..###.#.#
